ユノハナ大渓谷の: Scorch Gorge
ゴンズイ地区の: Eeltail Alley
ヤガラ市場の: Hagglefish Market
マテガイ放水路の: Undertow Spillway
ナメロウ金属の: Mincemeat Metalworks
クサヤ温泉の: Brinewater Springs
ヒラメが丘団地の: Flounder Heights
マサバ海峡大橋の: Hammerhead Bridge
キンメダイ美術館の: Museum d'Alfonsino
マヒマヒリゾート＆スパの: Mahi-Mahi Resort
海女美術大学の: Inkblot Art Academy
チョウザメ造船の: Sturgeon Shipyard
ザトウマーケットの: MakoMart
スメーシーワールドの: Wahoo World
シェケナダムの: Spawning Grounds
難破船ドン・ブラコの: Marooner's Bay
アラマキ砦の: Sockeye Station
ムニ・エール海洋発電所の: Gone Fission Hydroplant
レギュラーマッチの: Regular Battle
バンカラマッチの: Anarchy Battle
プライベートマッチの: Private Battle
ヒーローモードの: Story Mode
サーモンランの: Salmon Run
Xマッチの: X Battle
トリカラマッチの: Tricolor Battle
インク切れの: Inkless
週末の: Clocked-Out
目立ちたがりな: Attention-Seeking
左利きの: Southpaw
バンカラ街の: Splatsville's
物好きの: Big-Money
ふつうの: Normcore
まことの: Faithful
スーパー: Defensive
カリスマ: Champion
えいえんの: Royal
ブキ屋の: Ammo Knights
アタマ屋の: Naut Couture
フク屋の: Man-o'-Wardrobe
クツ屋の: Crush Station
ザッカ屋の: Hotlantis
ナワバトラー道場の: Tableturf Battling
研修中の: Research-Conducting
かけだしの: Apprentice
はんにんまえの: Part-Time
いちにんまえの: Go-Gettin'
じゅくれんの: Overachieving
たつじんの: Profreshional
でんせつの: Legendary
ラッシュ中の: Mid-Rush
満潮の: High-Tide
大量発生中の: Cohock-Chargin'
中の: Foggy
干潮の: Low-Tide
秋の: Fall-Lovin'
春の: Spring-Lovin'
冬の: Winter-Lovin'
夏の: Summer-Lovin'
ハッピーな: Blissed-Out
モードな: Trendy
エッジの効いた: Sharp-Edged
おしゃれな: Stylin'
クールな: Cool
シンプルな: Basic
トラディショナルな: Traditional
トレンドの: Trendsetting
ナチュラルな: All-Natural
ホットな: Sizzlin'
楽しむ: Day-Seizing
秋色の: Fall-Themed
春色の: Spring-Fresh
きれいめの: Captivating
ザ・: The
金欠の: Low-Rolling
リッチな: High-Rolling
司令にあこがれる: Commanding
ヒーローになりたい: Wannabe
百発百中の: Deadeye
つっぱしる: Reckless
冷静沈着な: Chilled-Out
ミュート中の: Silent
両利きの: Ambidextrous
立ってプレイする: Stand-Up
配信中の: Livestreaming
正座中の: Meditative
右利きの: Right-Handed
無口な: Low-Key
プロ級: Pro
アマチュア: Amateur
ハイカラスクエアの: Inkopolis Square's
ハイカラシティの: Inkopolis's Own
ハイカラな: Inkopolitan
野生の: Feral
都会の: Downtown
いなかの: Country-Born
どん欲な: Greedy
流行りの: Trending
裏通りの: Shortcut-Taking
夜型の: Fluid
楽しみな: Optimistic
夢見がちな: Daydreamin'
文化系: Clever
腹ペコの: Hungry Hungry
負けずぎらいな: Competitive
刃の: Slapdash
テキトーな: Half-Hearted
朝型の: Early-Bird
だいたんな: Daring
大食いの: Hungry
体育会系: Athletic
早朝の: Early-Morning
早撃ち: Inkslinging
早起きな: Up-and-at-'Em
深海の: Deep-Sea
寝起きの: Rise-and-Shine
渚の: Beachy
自由自在な: Freewheelin'
時代おくれの: Old-Fashioned
三国一の: World's Best
国民的: National
荒波の: Stormy
こどくな: Lonely
超えた: Groundbreaking
強気な: Assertive
子もだまる: Super-Scary
休日の: Vacationing
久しぶりの: Nostalgic
帰ってきた: Homecoming
がんばる: Hard-Workin'
甘党の: Sweet-Toothed
海の: Seafaring
自己流の: Self-Taught
夏休みの: Summer-Breaking
加工された: Processed
よごれた: Not-So-Fresh
塩味の: Salty
運まかせの: Destined
中の: Gullible
ワイプアウトの: Wiped-Out
ロックな: Rockin'
レトロな: Retro
ルーズな: Careless
よくばりな: Avaricious
ヤンチャな: Mischievous
やわらかい: Soft
無敵の: Unrivaled
ムキムキの: Swole
ポップな: Hip
フレッシュな: Brand-New
フルスロットル: Full-Throttle
ピチピチの: Peppy
犯人は: Law-Breaking
はたらく: At-Work
はじめての: The First
のびしろのある: Promising
塗りたくる: Ink-Sloshing
波乗り: Wave-Riding
トレンディーな: Swanky
とれたての: Fresh-Catch
データで戦う: Scientific
秩序の: Orderly
たったひとりの: The Lone
センチメンタルな: Sappy
スライドする: Dodge-Rolling
スミにおけない: Notable
瞬発力のある: Explosive
シャイな: Shy
シオカラ: Calamari
サバよんだ: Fishy
ケバ立つ: Puffed-Up
ケバい: Fuzzy
グレート: The Great
誕生日の: Birthday-Celebratin'
気まぐれな: Whimsical
キケンな: Dangerous
ガチ: Legit
おいしい: Dandy
ウルトラ: Ultra
ウキワの: Floaty
インドアな: Indoor
インクまみれの: Ink-Covered
インクしたたる: Ink-Dripping
イカす: Fresh
イカした: Wicked-Fresh
ありふれた: Stale
アッサリ系の: A Simple
８本足の: 8-Tentacled
１０本足の: 10-Tentacled
真冬の: Midwinter
想像以上に: Mind-Blowing
生涯: Lifelong
世界三大: Top-Ranked
実は: Actual
成長中の: Growing
身の: Studious
圧倒的: Overpowering
速い: Spineless
直撃する: Headstrong
はねる: Leaping
回る: Running
守る: Protective
攻める: Attacking
護衛好きな: Watchful
協力好きな: Cooperative
上手の: Hidden
センプクする: Submersible
ゴリ押しの: Brute
カバー好きな: Stealthy
平日の: Everyday
ゲーミング: Gaming
論理的な: Logical
頼もしい: Reliable
優しい: Gentle
自信満々の: Confident
まじめな: Serious
ひかえめな: Mild-Mannered
ゴキゲンな: Cheerful
グルメな: High-End
おしゃべりな: Chatty
おカネが全ての: Cash-Stacking
うっかりものの: Absentminded
愛にあふれた: Beloved
風の: Windy
水の: Watery
闇の: Sneaky
炎の: Fiery
光の: Incandescent
若い: Young
組織の: Organized
カンペキな: Perfect
国の: Mysterious
中心の: Central
モーレツな: Fierce
あいまいな: Ambiguous
刹那の: Instantaneous
涙の: Tear-Stained
旅行好きの: Traveling
来年の: Next Year's
時の: Twilight
唯一無二の: The One and Only
アブラの乗った: Beefy
強い: Sharp-Eyed
迷子の: Lost
本気出す: Procrastinating
名誉: Honorary
無味無臭の: Tasteless
無慈悲な: Merciless
無限の: Infinite
眠れる: Sleepy
来た: Time-Traveling
味のある: Suave
吠える: Howling
変幻自在の: Phantasmagoric
降りた: Celestial
くさっても: Aged
必殺の: Lethal
秘密の: Secret
秘伝の: Esoteric
おつかれの: Exhausted
比較的: Better-Than-You
汎用型: All-Purpose
発光する: Gleaming
白昼の: Midday
残った: Unnoticed
破天荒な: Unprecedented
ねばり強い: Tenacious
アツアツの: Scorching
日中の: Daytime
肉厚な: Meaty
ナゾの: Enigmatic
動じない: Unflappable
頭脳明晰な: Savvy
逃げる: Fleeing
電池切れの: Drained
転生した: Reincarnated
天日干しの: Sun-Dried
通称: AKA
超人的: Superhuman
地下生まれの: Subterranean
大量の: Massive
大地の: Terrestrial
大事な: Important
大漁の: Jumbo
大海の: Oceanic
大きな: Big
のんびりやの: Easygoing 
太古の: Ancient
増殖する: Multiplying
全自動: Fully Automatic
閃光の: Glimmering
船酔いした: Seasick
染まらない: Unblemished
戦う: Fightin'
行く: Front-Line
絶滅危惧種の: Endangered
上にも: Persistent
聖なる: Sacred
生まれながらの: Local
世紀末: Turn-of-the-Century
世紀の: This Century's Best
中の: Aquarium-Bound
推せる: Fan-Favorite
出てきた: Rising
辛党の: Spicy
神速の: Lightning-Fast
神がかった: Awe-Inspiring
真夜中の: Midnight
白な: Stark-White
赤な: Deep-Red
青な: Bright-Blue
黒な: Pitch-Black
森の: Woodsy
新世紀: Next-Generation
新手の: Novice
新感覚: Sensational
寝転ぶ: Dead-Tired
笑顔がまぶしい: Dazzling
招待された: Tagalong
小さな: Little
諸行無常の: Third-Eye-Opened
初夏の: Early-Summer
純白の: Alabaster
純粋な: Pure
熟成した: Grown-Up
祝・: Partying
渋い: Dapper
邪悪なる: Evil
漆黒の: Jet-Black
執念深い: Vindictive
自称: Self-Proclaimed
自撮りする: Selfie-Snapping
時の: Eternity's
私は: Self-Identified
子どもっぽい: Childish
仕事好きな: Job-Lovin'
残暑の: Late-Summer
斬新な: Cutting-Edge
山の: Mountain-Dwelling
撮影する: Picture-Taking
昨日は: Yesterday's
才色兼備な: Graceful
最前線の: First-Wave
最新型: All-New
最初の: The Very First
最後の: The Final
今年の: This Year's
特別: Limited-Edition
生きる: Ever-Present
とどろく: Booming
紅の: Crimson
硬派な: Steady
好奇心旺盛な: Nosy
悟った: Enlightened
孤高の: Aloof
健康的な: Hearty
芸術的な: Artsy
飛ぶ: Flying
筋金入りの: Die-Hard
強運の: Fortunate
去年の: Last Year's
究極の: The True Ultimate
鬼のような: Impish
かがやく: Shining
記憶のない: Forgetful
気持ちのこもった: Heartfelt
丸腰の: Unarmed
甘い: Sweet
感情的な: Sentimental
干潟の: Sandy
完全燃焼した: Overheated
海鮮: Catch-of-the-Day
海パン: Pool-Ready
来た: Anachronistic
音速の: Supersonic
恋する: Lovely
映画好きの: Movie-Lovin'
影の: Shadowy
運命の: Fated
宇宙の: Cosmic
思案な: Zipped-Lips
一本釣りの: Gone-Fishin'
一日: 24-Hour
いちおう: Mostly
異世界の: Otherworldly
わかばマークの: Junior-Grade
ワイルドな: Wild
リアルな: A Real
ラッキーな: Lucky
よく漬かった: Seasoned
ゆるふわ: Soft-and-Fluffy
やっぱり: 100%
野菜好きの: Veggie-Lovin'
もふもふの: Fluffy
モダンな: Modern
もう迷わない: Lost-and-Found
もう負けられない: Won't-Lose
めでたい: Auspicious
無邪気な: Innocent
ミラクル: Miraculous
ミーハーな: Poser
マンガ好きの: Comic-Lovin'
まな上の: Vulnerable
ホワイトな: Light
ボムの: Bomb-tastic
ペラペラの: Fluttering
ふわふわの: Buoyant
プルプルの: Wibbly-Wobbly
フルーツ好きの: Fruit-Lovin'
ブラックな: Dark
かぐわしい: Fragrant
ファッショナブル: Fashionable
ビッグな: Big-Time
びしょぬれの: Drenched
ヒゲの: Bearded
ヒエヒエの: Frosty
ハンパない: Incredible
彼方の: Faraway
ハデな: Flashy
バズりたい: Fame-Seeking
はじける: Bursting
ハイブランド好きの: Designer-Label
ハートを撃ちぬく: Swoon-Worthy
ハードな: Strict
ヌルヌルの: Slippery
塗りの: Painted
なんてったって: Climactic
名もなき: Nameless
ナイスな: Nice
ドロドロの: Muddy
となりの: Neighborly
ととのった: Tidy
トゲトゲの: Barbed
トガった: Pointy
デカい: Big Honkin'
つるつるの: Smooth
つめた～い: Iced
ちょっぴり: Occasional
ただの: Just Another
ダシがとれる: Essential
ダイビング: Diving
ダイナマイトな: Dynamite
そんなこんなで: Overall
せっかちな: Bargain-Binned
スリムな: Slim
すみっこの: Out-of-Options
スチームパンクな: Steampunky
しびれる: Numb
さんぽ好きの: Hiking
さまよえる: Wandering
ゴワゴワの: Unyielding
コスパのいい: Economical
ゴシック: Gothic
高性能の: High-Performing
けなげな: Praiseworthy
ゲーセンの: Arcade-Hopping
グッド: Pretty Good
空前絶後の: The GOAT
ギラギラな: Glistening
キラキラな: Sparkling
巨大化した: Gigantified
カメラ目線の: Camera-Facing
カチカチの: Clockwork
かたい: Solid
１００％: Fully
隠れた: Unperceived
お肉好きの: Carnivorous
お間の: Homebound
お魚好きの: Fish-Lovin'
お絵描きする: Sketching
おませな: Precocious
おちゃのこさいさい: Easy-Peasy
オーダーメイドの: Made-to-Order
エレガントな: Elegant
エラ呼吸の: Water-Breathing
エターナル: The Eternal
インスタント: Instant
いつもの: The Usual
いつだって: Ready-to-Go
イキのいい: Lively
いい波乗ってる: Unstoppable
アングラの: Underground
アルティメット: The Real Ultimate
あふれ出る: Overflowing
アニメ好きの: Toon-Lovin'
あっぱれ: Splendid
あったか～い: Warm-and-Cozy
アガる: Amped-Up
アウトドアな: Outdoorsy
IT界の: Tech-Minded
I LOVE : Lovable
amiiboの: amiibo-Collecting
５年後には: 5-Year-Planning
１０年前は: Decade-Experienced
サンカクスの: Crab-N-Go
夏色の: Summer-Fun
冬色の: Winter-Ready
配信終わりの: Not-Streaming
昼型の: Daylit
夜明けの: Dawning
リアリストな: Realistic
小食の: Lightly Snacking
夜ふかしの: Late-Night
ふとんの中の: Comfy-Cozy
弱気な: Fearful
冬休みの: Winter-Breaking
いわゆる: So-Called
信じる: Intuitive
こってり系の: A Complex
初代: The Original
二代目: Second-Generation
最高の: The Best
さすらいの: Roaming
DJ: DJ
荒野の: Badlands
雪原の: Snowy
海辺の: Seaside
大空の: Big-Sky
チョーシあげたい: Dry
チョーシぼちぼちの: Raw
チョーシいい: Awesome
チョーシサイコーの: SUPERFRESH
スプラトゥーンの: Splatoon
アバンギャルド: Avant-Garde
パンク: Punk
モッズ: Mod
ゴス: Goth
ロカビリー: Rockabilly
アメカジ: Casual
スポーティー: Sporty
B系: Breakin'
ヴィジュアル系: Glam
古着: Vintage
エスニック系: Bohemian
グランジ: Grunge
ヒップホップ: Hip-Hop
雷の: Thunderous
電光石火の: Turbo
老いた: Wizened
今日は: Today's
VR: Virtual
５０％: Half
３％: Microscopic
モノクロの: Monochrome
長そでの: Long-Sleeved
大大吉の: Super-Duper Lucky
激レアの: Super-Rare
バンカラな: Splatlandian
インド洋の: Indian Ocean
北大西洋の: North Atlantic
北太平洋の: North Pacific
南極海の: Antarctic Ocean
北極海の: Arctic Ocean
南大西洋の: South Atlantic
南太平洋の: South Pacific
イカッチャの: The Shoal's Own
クマサン商会の: Official-Grizzco
クレーターの: The Crater's
広場の: The City's Own
ロビーの: Lobby-Bound
三代目: Third-Gen
混沌の: Chaotic
真夏の: Midsummer
オルタナの: Alternan
エンジョイ: Fun
最強の: The Strongest
アゲアゲの: Crusty
立ちこぎの: Saddle-Straddlin'
コラボ好きの: Collab-Loving
例えるなら: Exemplary
マンタマリア号の: Manta Maria
一万人に一人の: One-in-a-Million
サクサクの: Streamlined
ストリート系: Swaggy
ナンプラー遺跡の: Um'ami Ruins		
